.....................
....................
....................
....................
....................
....................C
..................###
...........CCC......
...........###......
......CCC...........
......###.......CCC
................###GG
.###................
....................
####################
